{
  "keys": [
    [
      ["²", "²"],
      ["&", "1"],
      ["é", "2"],
      ["\"", "3"],
      ["'", "4"],
      ["(", "5"],
      ["-", "6"],
      ["è", "7"],
      ["_", "8"],
      ["ç", "9"],
      ["à", "0"],
      [")", "°"],
      ["=", "+"],
      ["Backspace"]
    ],
    [
      ["Tab"],
      ["a", "A"],
      ["z", "Z"],
      ["e", "E"],
      ["r", "R"],
      ["t", "T"],
      ["y", "Y"],
      ["u", "U"],
      ["i", "I"],
      ["o", "O"],
      ["p", "P"],
      ["^", "¨"],
      ["$", "*"],
      ["*", "$"]
    ],
    [
      ["CapsLock"],
      ["q", "Q"],
      ["s", "S"],
      ["d", "D"],
      ["f", "F"],
      ["g", "G"],
      ["h", "H"],
      ["j", "J"],
      ["k", "K"],
      ["l", "L"],
      ["m", "M"],
      ["ù", "%"],
      ["Enter"]
    ],
    [
      ["Shift"],
      ["<", ">"],
      ["w", "W"],
      ["x", "X"],
      ["c", "C"],
      ["v", "V"],
      ["b", "B"],
      ["n", "N"],
      [",", ","],
      [";", ";"],
      [":", "."],
      ["!", "/"],
      ["Shift"]
    ],
    [["Control"], ["Win"], ["Alt"], [" "], ["Alt"], ["Fn"], ["Control"]]
  ],
  "size": {
    "Backspace": "five",
    "Tab": "five",
    "CapsLock": "seven",
    "Shift": "double",
    "Control": "two",
    "Alt": "two",
    "Win": "two",
    "Fn": "two",
    " ": "space",
    "Enter": "seven"
  }
}
