{
  "qwerty": {
    "keys": [
      [
        ["`", "~"],
        ["1", "!"],
        ["2", "@"],
        ["3", "#"],
        ["4", "$"],
        ["5", "%"],
        ["6", "^"],
        ["7", "&"],
        ["8", "*"],
        ["9", "("],
        ["0", ")"],
        ["-", "_"],
        ["=", "+"],
        ["Backspace"]
      ],

      [
        ["Tab"],
        ["q", "Q"],
        ["w", "W"],
        ["e", "E"],
        ["r", "R"],
        ["t", "T"],
        ["y", "Y"],
        ["u", "U"],
        ["i", "I"],
        ["o", "O"],
        ["p", "P"],
        ["[", "{"],
        ["]", "}"],
        ["\\", "|"]
      ],
      [
        ["CapsLock"],
        ["a", "A"],
        ["s", "S"],
        ["d", "D"],
        ["f", "F"],
        ["g", "G"],
        ["h", "H"],
        ["j", "J"],
        ["k", "K"],
        ["l", "L"],
        [";", ":"],
        ["'", "\""],
        ["Enter"]
      ],
      [
        ["Shift"],
        ["z", "Z"],
        ["x", "X"],
        ["c", "C"],
        ["v", "V"],
        ["b", "B"],
        ["n", "N"],
        ["m", "M"],
        [",", "<"],
        [".", ">"],
        ["/", "?"],
        ["Shift"]
      ],
      [["Control"], ["Win"], ["Alt"], [" "], ["Alt"], ["Fn"], ["Control"]]
    ],
    "size": {
      "Backspace": "five",
      "Tab": "five",
      "CapsLock": "seven",
      "Shift": "double",
      "Control": "two",
      "Alt": "two",
      "Win": "two",
      "Fn": "two",
      " ": "space",
      "Enter": "seven"
    }
  }
}
